111111
1C0011
10P001
1ER011
111111