11111111111111111
10P100C0000C00001
100100C0000C00001
10000C000C0001111
100100C00E0001101
100100C0000C00001
11111111111111111