111111111111111111111111111111111111111111111111111111111111111111111111111111111111111111111111111
10P100C0000C000001100C0000C000001100C0000C000001100C0000C000001100C0000C000001100C0000C000000000001
100100C0000C000011100C0000C000001100C0000C000001100C0000C000001100C0000C000001100C0000C000000000001
10000C000C00011111100C0000C000001100C0000C000001100C0000C000001100C0000C000001100C0000C000000000001
100100C00000E11011100C0000C000001100C0000C000001100C0000C000001100C0000C000001100C0000C000000000001
100100C0000C000011100C0000C000001100C0000C000001100C0000C000001100C0000C000001100C0000C000000000001
111111111111111111111111111111111111111111111111111111111111111111111111111111111111111111111111111