1111110111111
10010000000C0
1000011111001
0P0011E000001
1111111101111